rainbow: a band of colors
mammoth: large#abc#xyz
steak: meat you eat
piglet: a baby pig
counsel: to give advice
slumber: sleep#abc#xyz	
dim: not much light			
neat: tidy	
rowboat: small boat  moved by rowing	
break: shatter
through: from here to there	
geese: large birds that make honking sound
creek: a smaller# moving body of water
coast: land along the sea 
rigid: stiff#abc#xyz
whale: a large animal living in the sea
furious: angry#abc#xyz
attic: at the top of the house
stake: a stick that you hammer into ground	
adult: grownup	
prank: trick#abc#xyz		
patio: a paved area near a house	
pause: take a break	
stalk: stem	#abc#xyz
orbit: circle#abc#xyz
loyal: faithful#abc#xyz
moose: a large animal with antlers	
berry: a fruit		
shriek: a loud sound	
slosh: splash#abc#xyz
threw: past tense of throw
grandchildren: children of your children		
reply: answer#abc#xyz	
applesauce: made when cooking apples
yearn: to really long for something	
joey: a baby kangaroo#abc#xyz
kid: a young goat#abc#xyz		
fir: a kind of evergreen tree		
foe: enemy#abc#xyz
record: to write down/something important  	
zoo: a place where animals are kept	
freighter: a ship that carries cargo#abc#xyz 
ill: sick#abc#xyz
ant: an insect	
vacant: empty#abc#xyz
bothersome: annoying#abc#xyz
kit: a baby fox 	
birdbath: bath for birds
mitt: what baseball players catch with
fur: covering of most animals
turtleneck: a long neck
bravo: what an audience yells when they like the performance
flexible: bends easily#abc#xyz	
keyboard: part of a piano that you play	
hillside: steep# sloping land
exam: a kind of test	
shallow: not much water#abc#xyz
foal: a young horse or donkey#abc#xyz
sketches: quick drawings
purchase: buy#abc#xyz	
gracious: polite
feeble: weak#abc#xyz	
lurk: wait#abc#xyz
pleasure: a happy feeling
garage: a place to park cars
overcast: cloudy#abc#xyz
bright: light	
cellar: at the bottom of the house	
ballet: a form of dance	
banner: flag#abc#xyz
echoes: repeated sounds
frayed: worn#abc#xyz
eyelid: protects your eye			
absent: missing#abc#xyz	 
annual: yearly#abc#xyz
infant: baby	
noodle: made of flour# water# and eggs		
council: a group of people making plans		
repair: fix		
principal: the head of a school		
lab: where scientists do their research
sheep: animals whose fur is used for wool
cygnet: a young swan#abc#xyz	
voyage: trip#abc#xyz
math: the study of numbers# shapes# and measurements 
shiver: shudder#abc#xyz
wail: cry	
data:d1#d2#d3
bike: something you pedal to make its wheels move
assist: help#abc#xyz
glee: joy
deep: many feet of water#abc#xyz		
chipmunk: a small animal resembling a squirrel
borrow: you get something		
peak: top of a mountain		
plea: to beg for something
lend: to give something			
feet: at  he end of our legs 
peek: to look	
wild: untamed#abc#xyz
scorekeeper: someone who keeps score	
pain: what you feel when something bad happens#abc#xyz
springboard: flexible board to jump from
fern: a kind of plant	
sloppy: messy	
drowsy: sleepy#abc#xyz	
dove: bird/past tense of dive  
helm: the wheel used for steering the ship#abc#xyz
sturdy: strong#abc#xyz	
wind: air that moves/to turn 
task: job#abc#xyz
plaza: an open space in a city or town
loft: a room just under the roof of a building
boss: the person in charge of a job    
aunt: female relative	
auto: a form of transportation	
oxen: large farm animals in the cattle family	
paws: feet		
limb: a branch of a tree	
sub: something that travels under water
bury: to cover up	
homework: assignment done at home	
lead: to be at the beginning/a type of metal	
spaceship: what an astronaut rides in
waterfall: when water drops over a cliff
cub: a young bear# lion# or tiger
halves: two equal parts	
principle: a rule
pizza: a kind of pie with cheese and tomatoes on a crust
hairbrush: what you use to brush hair	
lunchtime: middle meal of the day
bus: what some kids ride to school 
rude: not polite
gosling: a baby goose
fawn: a baby deer
beehive: where bees make honey
kindergarten: before 1st grade
live: living/to dwell
dinghy: a small boat
crosswalk: where you should cross street
catfish: a fish with whiskers	
calf: a baby cow# elephant# or whale	
railroad: what trains travel on		
mysteries: things that are secret or hard to explain	
bungalow: a small# one story house	
meadow: field#abc#xyz
host: one who gives the party
sandbox: where kids play with sand
drum: something you hit to make sounds
